W W W W W W W W W W W W W W W W W W W
W S S S S B S S S W S S S S S S S S W
W S W W S W W W W W W W W W S W W B W
W S S S S S S S S S S S S S S S S S W
W S W W S W S W W W W W S W S W W S W
W S S S S W S S S W S S S W S S S S W
W W W W S W W W E W E W W W S W W W W
E E E W S W S E E E E E S W S W E E E
W W W W S W S W E W E W S W S W W W W
S S S S S S S W 1 E 2 W S S S E E B E
W W W W S W S W W W W W S W S W W W W
S S S S S W S S S S S S S W S W S S S
W W W W S W S W W W W W S W S W W W W
W S S S S S S S S W S S S S S S S S W
W S W W S W W W W W W W W W S W W S W
W S S W S S S S S P S S S S S W S S W
W W S W S W S W W W W W S W S W S W W
W S S S S W S S S S S S S W S S S S W
W S W W W W W W S W S W W W W W W S W
W B S S S S S S S S S S S S S S S S W
W W W W W W W W W W W W W W W W W W W